1111111111111111111111111111111111111
1E000000C0000000000111111111111111111
1000001000001110001111111111111111111
1001111100001110001111111111111111111
100000100000111000111100000C111111111
1000001000001111111111101111111111111
1001101000001110000000000011111111111
1011101000001110001101111111111111111
1000001000000110000001111111111111111
10C00010000000100P0011111111111111111
1000000000000010000000111111111111111
1000001000001111111110111111111111111
1110111000001110000000000000111111111
1000001000001110001111111100011111111
1000001000001110001110000111001111111
1000001000C01110001000001110001111111
1000001000001110000001111100111111111
1000100000111000001111111110111111111
11C0000000000000000000001000001111111
1111111111111111111111111111111111111
