1111111111111111111111111111111111111
1E000000C0000000000111111111111111111
1000001000001110001111111111111111111
1000001000001110001111111111111111111
1000001000001110001111111111111111111
1000001000001110001111111111111111111
1000001000001110001111111111111111111
1000001000001110001111111111111111111
1000001000001110001111111111111111111
1000001000001110001111111111111111111
1000001000001110001111111111111111111
1000001000001110001111111111111111111
1000001000001110001111111111111111111
1000001000001110001111111111111111111
1000001000001110001111111111111111111
1000001000001110001111111111111111111
1000001000001110001111111111111111111
1000001000001110001111111111111111111
1P00000000000000000111111111111111111
1111111111111111111111111111111111111
